_____________
_____________
_____________
___111111____
__1_____r1___
___111111____
_____________
_____________
_____________