1 0
_________________e___________e______e______e___e_______e____e________e______e_
____________________c__e_c_______e__________c______c___e_______c____________e_
________________e____e________e________e___e________e__________e_____e__e_____
_________________e______e________e_________e_____e_________e______e__c___e____
______________e____e_c______e________e_____________c_c_e_______e______________
__________________c_________e___c__c_____e_________e__________e______e__e_____
________________e__e__c________e____e________c_e___e_____________e__________e_
___________________________e______e________e_____c____________e_________e_____
________________e_____e__________e_________e_______e___e_______e_____e________