0 8
____________a_______a___a______a______a___a_______a____a________a______a_
__________a_______a_________a__________a______a___a_______a____________a_
___________a____a________a________a_______a____a_______a________a__a_____
___________________a________a_________a_______________a______a______a____
_________a____a_a_______________a________a______a____________________a___
_______________________a___a________a_________a_____a____a______a__a_____
______________a__a_______a_______a________a_______a_________a__________a_
___________a_________________a________a_____________a_________a____a_____
___________a_____a_______a__a______a__________a___a_______a_____a________