1 0
_________________e___________e______e______e___e_______e____e________e______e_
____________________e__e_________e__________e______e___e_______e____________e_
________________e____e________e________e___e________e__________e_____e__e_____
_________________e______e________e_________e_____e_________e______e______e____
______________e____e________e________e_____________e___e_______e______________
__________________e_________e____________e_________e__________e______e__e_____
________________e__e__e________e____e__________e___e_____________e__________e_
___________________________e______e________e__________________e_________e_____
________________e_____e__________e_________e_______e___e_______e_____e________