0 0
_0_0__0__000_
_1_1_101_1_1_
_0_0___0__g__
_1_1_101_1_1_
__0__00__r0__
r101_101_101_
0___00___r___
_101_1_1_1_1_
__0___0r__g__