0 0
______0____0g
_101_101_1_1_
___0r_00__0__
_1_10101_1_1_
__0_00__r_0__
_101_101_101_
0_0__g_0_g__0
_101_10101_1_
__0__r0___0__