0 0
_000__0____0_
_101_101_1_1_
__00r__0__g__
_1_1_101_1_1_
__0__0_r__0__
_1010101_101_
0_0_g__0____0
_101_10101_1_
__0___0______